111210121111
100000100011
100000000011
100000100011
111211112111
100000000001
111111111111
012012012012
120120120120
201201201201